あわてる	/panic	短縮よみ
いえす	/yes	短縮よみ
いかり	/angry	短縮よみ
いかる	/angry	短縮よみ
いねむり	/doze	短縮よみ
ううん	/no	短縮よみ
うぇるかむ	/welcome	短縮よみ
うん	/nod	短縮よみ
うん	/yes	短縮よみ
うんざり	/disgusted	短縮よみ
うんざり	/upset	短縮よみ
えもーと	/emote	短縮よみ
おうえん	/cheer	短縮よみ
おこる	/angry	短縮よみ
おじぎ	/bow	短縮よみ
おちこむ	/sigh	短縮よみ
おっけー	/nod	短縮よみ
おっけー	/yes	短縮よみ
おどり	/dance	短縮よみ
おどる	/dance	短縮よみ
おどろき	/amazed	短縮よみ
おどろき	/surprised	短縮よみ
おどろく	/amazed	短縮よみ
おどろく	/surprised	短縮よみ
おー	/hurray	短縮よみ
おーけー	/nod	短縮よみ
おーけー	/yes	短縮よみ
かちどき	/hurray	短縮よみ
かんがえる	/think	短縮よみ
かんげい	/welcome	短縮よみ
がっかり	/sigh	短縮よみ
がっくり	/sigh	短縮よみ
がんばれ	/cheer	短縮よみ
きあい	/psych	短縮よみ
くやしい	/fume	短縮よみ
ぐうぐう	/doze	短縮よみ
ぐっばい	/goodbye	短縮よみ
けいれい	/salute	短縮よみ
さようなら	/farewell	短縮よみ
さようなら	/goodbye	短縮よみ
さよなら	/farewell	短縮よみ
さよなら	/goodbye	短縮よみ
しつもん	/amazed	短縮よみ
しょうげき	/shocked	短縮よみ
しょうさん	/praise	短縮よみ
しょっく	/shocked	短縮よみ
じだんだ	/fume	短縮よみ
すねる	/sulk	短縮よみ
すまいる	/smile	短縮よみ
そんけい	/kneel	短縮よみ
たたえる	/praise	短縮よみ
たたく	/slap	短縮よみ
だまる	/muted	短縮よみ
だめ	/no	短縮よみ
だんす	/dance	短縮よみ
つつく	/poke	短縮よみ
つんつん	/poke	短縮よみ
てれる	/blush	短縮よみ
てをふる	/wave	短縮よみ
といつめる	/doubt	短縮よみ
なく	/cry	短縮よみ
なぐさめる	/comfort	短縮よみ
なげる	/toss	短縮よみ
にこり	/smile	短縮よみ
にやり	/grin	短縮よみ
ねる	/doze	短縮よみ
のー	/no	短縮よみ
はくしゅ	/clap	短縮よみ
ばいばい	/farewell	短縮よみ
ばいばい	/goodbye	短縮よみ
ぱちぱち	/clap	短縮よみ
ぱにっく	/panic	短縮よみ
ひざまづく	/kneel	短縮よみ
びっくり	/amazed	短縮よみ
びっくり	/surprised	短縮よみ
ほほえむ	/smile	短縮よみ
みつめる	/stare	短縮よみ
ゆびさす	/point	短縮よみ
ようこそ	/welcome	短縮よみ
よろこび	/joy	短縮よみ
よろこぶ	/joy	短縮よみ
よろめく	/stagger	短縮よみ
りかいふのう	/huh	短縮よみ
れい	/bow	短縮よみ
わらい	/grin	短縮よみ
わらい	/laugh	短縮よみ
わらう	/grin	短縮よみ
わらう	/laugh	短縮よみ
わーい	/joy	短縮よみ
わーん	/cry	短縮よみ
